SGGGGGGGGGGGGGGGGGGGGGGGS
GGGGGGGGGGGGGGGGGGGGGGGGG
GGGWWWWWGGWGGGWGGWWWWWGGG
GGGGGWGGGGWGGGWGGWGGGGGGG
GGGGGWGGGGWWWWWGGWWWWGGGG
GGGGGWGGGGWGGGWGGWGGGGGGG
GGGGGWGGGGWGGGWGGWWWWWGGG
GGGGGGGGGGGGGGGGGGGGGGGGG
GGGWWWWWGGWWGGWGGWWWWGGGG
GGGWGGGGGGWWWGWGGWGGGWGGG
GGGWWWWGGGWGWGWGGWGGGWGGG
GGGWGGGGGGWGWWWGGWGGGWGGG
GGGWWWWWGGWGGWWGGWWWWGGGG
GGGGGGGGGGGGGGGGGGGGGGGGG
SGGGGGGGGGGGGGGGGGGGGGGGS