GGGGGGGGGGGGGGGGGGGGGGGGG
WWWWWWIWWWWWIWWWWWIWWWWWW
WGGGGGWGGGGGWGGGGGWGGGGGW
WGGSGGWGGSGGWGGSGGWGGSGGW
WGGGGGWGGGGGWGGGGGWGGGGGW
WWWWWWIWWWWWIWWWWWIWWWWWW
WGGGGGWGGGGGWGGGGGWGGGGGW
WGGSGGWGGSGGWGGSGGWGGSGGW
WGGGGGWGGGGGWGGGGGWGGGGGW
WWWWWWRWWWWWRWWWWWRWWWWWW
WGGGGGWGGGGGWGGGGGWGGGGGW
WGGSGGWGGSGGWGGSGGWGGSGGW
WGGGGGWGGGGGWGGGGGWGGGGGW
WWWWWWRWWWWWRWWWWWRWWWWWW
WWWWWWWWWWWGGGGWWWWWWWWWW
