SGGGGGGSGGGGGGGGGSGGGGGGS
GRRRRRRRRRRGGGRRRRRRRRRRG
WWWWWWWWWWWWWWWWWWWWWWWWW
GGGIIIIIIGGGGGGGIIIIIIGGG
GGGIIIIIIWWWWWWWIIIIIIGGG
GGGIIIIIIGGGGGGGIIIIIIGGG
WWWIIIIIIWWWWWWWIIIIIIWWW
WWWWWWWWWWWWWWWWWWWWWWWWW
GWGWGWGWGWGWGWGWGWGWGWGWG
WGWGWGWGWGWGWGWGWGWGWGWGW
GRRRGGGGGGGGGGGGGGGGGRRRG
WWWWWWWWWWWWWWWWWWWWWWWWW
IIIIIIIIGGGGGGGGGIIIIIIII
WWWWWWWGGGGGGWWWWWGGGGWWW
WWWWWWWWWWWWWGGGGGWWWWWWG


