IIIIIIIISGGGGGGSIIIIIIIII
ISGGGGGGGGGGGGGGGGGGGGGSI
IGGGGGGGGGGGGGGGGGGGGGGGI
IGGGGGRRRRRRRRRRRRRRGGGGI
IGGGGRRRRRRRRRRRRRGGGGGGI
IGGGGGGGGGGGGGGGGGGGGGGGI
GGGGGGGGGGGGGGGGGGGGGGGGI
GGGRRRRRRRRRRRRRRRRRRRRRR
GGGGGGGGGGGGGGGGGGGGGGGGG
RRRRRRRRRRRRRRRRRRRRRRGGG
GGGGGGGGGGGGGGGGGGGGGGGGG
GGGGRRRRRRRRRRRRRRRRRRRRR
GGGGGGGGGGGGGGGGGGGGGGGGG
RRRRRRRRRRRRRRRRRRRRRRRGG
GGGGGGGGGGGGGGGGGGGGGGGGG