GGGGSGGGGGSGGGGSGGGGGGGGS
IIIIWIIIIIWWWWWWIIIIIWIII
IGGGGGGGGIRRWWRRIGGGGGGGI
IWWWWWWWWIRRWWRRIGGGGGGGI
IGGGGGGGGIRRWWRRIWWWWWWWI
IGGGGGGGGWWWWWWWWGGGGGGGI
WWRRRRRRWWWWWWWWWWRRRRRWW
IGGGGGGGGIRRWWRRIGGGGGGGI
IWWWWWWWWIRRWWRRIGGGGGGGI
IGGGGGGGGIRRWWRRIWWWWWWWI
IGGGGGGGGWWWWWWWWGGGGGGGI
WWRRRRRRWWWWWWWWWWRRRRRWW
GGGGGGIIIIIGGGGGIIIIGGGGG
WWWWWWGGGGWWWWWWGGGWWWWWW
GGGGIIIWWWWGGGGWWIIIGGGGG



