GGGGGGGGGGGGGGGGGGGGGGGGG
GRRGRRGGGGGGWWWWGGGRRGRRG
GRGGGRGGGGGGWGGGGGGRGGGRG
GGGSGGGGGGGGWGGGGGGGGSGGG
GRGGGRGGGGGGWGGGGGGRGGGRG
GRRGRRGGGGGGWGGGGGGRRGRRG
GGGGGGGGGGGGWGGGGGGGGGGGG
GWWWWWGGGIIIIIIIGGGWWWWWG
GGGGGGGGGGGGWGGGGGGGGGGGG
GRRGRRGGGGGGWGGGGGGRRGRRG
GRGGGRGGGGGGWGGGGGGRGGGRG
GGGSGGGGGGGGWGGGGGGGGSGGG
GRGGGRGGGGGGWGGGGGGRGGGRG
GRRGRRGGGWWWWGGGGGGRRGRRG
GGGGGGGGGGGGGGGGGGGGGGGGG