SGGGGGGSGGGGGGGGGSGGGGGGS
GWGWGWGWGWGWGWGWGWGWGWGWG
GWGWGWGWGWGWGWGWGWGWGWGWG
GWGWGWGWGWGWGWGWGWGWGWGWG
GWGWGWGWGWGWGWGWGWGWGWGWG
GWGWGWGWGWGWGWGWGWGWGWGWG
GWGWGWGWGWGWGWGWGWGWGWGWG
GGGGGGGGGGGGGGGGGGGGGGGGG
GWGWGWGWGWGWGWGWGWGWGWGWG
GWGWGWGWGWGWGWGWGWGWGWGWG
GWGWGWGWGWGWGWGWGWGWGWGWG
GWGWGWGWGWGWGWGWGWGWGWGWG
GWGWGWGWGWGWGWGWGWGWGWGWG
GWGWGWGWGWGWGWGWGWGWGWGWG
GGGGGGGGGGGGGGGGGGGGGGGGG