GGGGGGGSGGGGGGGGSGGGGGGGG
SGGIIIIIIGGGGGGGIIIIIIGGS
WWIWWIWWIWWIWWIWWIWWIWWIW
GGGGGGGGGGGGGGGGGGGGGGGGG
GGGGGGGGGGGGGGGGGGGGGGGGG
IIWIIWIIWIIWIIWIIWIIWIIWI
GGGGGGGGGGGGGGGGGGGGGGGGG
GGGGGGGGGGGGGGGGGGGGGGGGG
IIIIIIIIIWWWWWWWWWWIIIIII
RRRRGGGGGGGGGGGGGGGGRRRRR
GGGGGGGGGGGGGGGGGGGGGGGGG
GGGGGGGGGGGGGGGGGGGGGGGGG
RRRRWWWWRRRRRRWWWWWWWRRRR
WWWWWWWWWWWWWWWWWWWWWWWWW
GGGGIIIWWWWGGGWWWGWWWWWWG

