SGGGGGGGGGGGGGGGGGGGGGGGS
WWWIIIWIWRRRRRIIRIWWWWWWI
GGGGGGSWWGWIWGWIWSWWWWGII
IWWWGGGGGGRRRIWWWWWWWWWWW
GGGGWWWWWWWWWWWWWGGGGGGGG
WWWWWWIIIIIIIIIIIIIWWWWWW
WWWWWWGGGGGGGGGGGGGWWWWWW
GGGGGGGGGGGGGGGGGGGGGGGGG
WWWWWIWIIWIWIWIWIWIWIWWWW
WWWWRRRRRRGGGGGGRRRRWWWWW
RGGGGGGGGWWWWWWWGGGWWWWWR
WWWWWWWWWWWWWWWWWWWWWWWWW
WWWGGGGGGGWWWWWWGGGGGGWWW
WWWGGGGGGGGWWWWGGGGGGGWWW
GGGGGGGGGGWWGGWWGGGGGGGGG