GGGGGGGGGGGGSGGGGGGGGGGGG
GGSIIIIIIIIWWWIIIIIIIISGG
WWIIIIIWIIIIIIIIIIIIIWGGI
WWWWWWWWWWWWWWWWWWWWWWWWW
GGGGRRRRRRRRWWWWWRGRGRGRR
WWWWWWWIIIIIIIIIIWWWWWWWW
WGGGGGWRRRRRRRRRRWGGGGGGW
WGGGGGWRRRRRRRRRRWGGGGGGW
WWIIIWWWWWWWWWWWWWWIIIIWW
GGGGGGGGGGGGSGGGGGGGGGGGG
IIIIIIIWWWWWWWWIIIIIIIIII
WWWWWWWWWWWWWWWWWWWWWWWWW
RRRRRRRWWWWWWWWRRRRRRRRRR
GGGGRRRRRGGGGGIIIIGGGGGGG
WWWWWWWWWWWGGGGWWWWWWWWWG