SGGGGGGGGGGGGGGGGGGGGGGGS                         
GIIIIGGSWWWWWWWWWWIWSGGGG
GGGGGGGGGWWWWWWWWWWWGWWWW
RRRRWWWWGWGGGIIIWWWWGGGGG
GGGGGGGGGWWWWWWWWWWWGGGGG
GGGGGGGGGWWWWWWWWWWWGWWWW
RRRRWWWWGWGGGGGGGGGWGGGGG
WWWWWWWWGWWWWIIIWWWWGRRRR
GGIIWWWWGWWWWWWWWWWWGGGGG
GGGGIIGGGWGGGGGGGGGWGWWWW
WWWWWWWWGWWWWWWWWWWWGGGGG            
WWWWWWWWGGGGGGIIWWWWWWGGG
RRRRGGGGGGGGWWWWWWWWWWGGG
WWWWWWWWWWWIIIIWWWWWWWWWW
GGGWWWWWWWWGGGGGGWWGGWWGG