SGGGGGGGGGGGGGGGGGGGGGGGS
WWWWWWWWWWWWWWWWWWWWWWWWW
GGGGGGGIIIIIIIGGGGGGWWWWW
WWWWWWWWWWWWWWWWWWWWWWWWW
WWWWWGGGGGGGRRRRRRRGGGGGG
WWWWWWWWWWWWWWWWWWWWWWWWW
GGGGGGIIIIIIGGGGGGGGWWWWW
WWWWWWWWWWWWWWWWWWWWWWWWW
WWWWWGGGGGGGRRRRRRGGGGGGG
WWWWWWWWWWWWWWWWWWWWWWWWW
GGGGIIIIIIIIGGGGGGGGWWWWW
WWWWWWWWWWWWWWWWWWWWWWWWW
WWWWWGGGGGRRRRRRGGGGGGGGG
WWWWWWWWWWWWWWWWWWWWWWWWW
SGGGGGGWWWGGGGGWWWGGGGGGS