SGGGGGGGGGGGGGGGGGGGGGGGS
WWWWWWWGGGRRRRRGGWWWWWWWW
GGGGGGGWWWWWWGGGGGGGGGGGG
GGGGGGGGGGRRRRRWWWWWWGGGG
GGGGGGGGWWWWWWWWGGGGGGGGG
WWWWWWWWWGRRRRRGWWWWWWWWW
GGGGGGWWWWWWWWWWWWGGGGGGG
WWWWWWWGGGRRRRRGGGGGGGGGG
GGGGGGWWWWWWWWWWWWGGGGGGG
GGGGGGGGGGGGGGGGWWWWWWWWW
WWWWWWWWWWRRRRRGGGGGGGGGS
GGWWWGGWWWGGWWWGGWWWGGWWW
SGWWWGGWWWGGWWWGGWWWGGWWW
WWWWWWWWWWWWWWWWWWWWWWWWW
IIWWWWWWWGGGGGGGGWWWWWWII