GGGGGGGGGGGGGGGGGGGGGGGGG
GGWWWWGGWWWWGGWWWWGGWWWWG
GGGGGWGGGGGWGGGGGWGGGGGWG
GGWWWWGGWWWWGGWWWWGGWWWWG
GGWGGGGGGGGWGGGGGWGGGGGWG
GGWWWWGGWWWWGGWWWWGGWWWWG
GGGGGGGGGGGGGGGGGGGGGGGGG
WIWIWIWIWIWIWIWIWIWIWIWIW
WWWWWWWWWWWWWWWWWWWWWWWWW
WRWRWRWRWRWRWRWRWRWRWRWRW
GGGWWGGGWWGGGWWGGGWWGGGWW
GSGWWGSGWWGSGWWGSGWWGSGWW
GGGWWGGGWWGGGWWGGGWWGGGWW
WWWWWWWWWWWWWWWWWWWWWWWWW
GGGGGGGGGGGGGGGGGGGGGGGGG
